谚文字母	朝鲜 KPS 9256（QWERTY）	韩国 KS X 5003（QWERTY）
ㄱ	s	r
ㄴ	f	s
ㄷ	e	e
ㄹ	r	f
ㅁ	w	a
ㅂ	q	q
ㅅ	g	t
ㅇ	d	d
ㅈ	a	w
ㅊ	v	c
ㅋ	z	z
ㅌ	x	x
ㅍ	c	v
ㅎ	t	g
ㄲ	S	R
ㄸ	E	E
ㅃ	Q	Q
ㅆ	G	T
ㅉ	A	W
ㅏ	j	k
ㅑ	m	i
ㅓ	i	j
ㅕ	y	u
ㅗ	h	h
ㅛ	n	y
ㅜ	u	n
ㅠ	b	b
ㅡ	l	m
ㅣ	k	l
ㅐ	o	o
ㅒ	O	O
ㅔ	p	p
ㅖ	P	P
